###########################################################################################################################
#                                                                                                                         #
#                                                                                                                         #
#                                                                                                                         #
#                                                                                                                         #
#                                                                                                                         #
#                                                                    ####                                                 #
#                                                                    ####                                                 #
#                                                                    ####                                                 #
#                                                                    ####                                                 #
#                                                                                                                         #
#                                                                                                                         #
#                                                                                                                         #
#                                                                                                                         #
#                                                   ####                                                                  #
#                                                   ####                                                                  #
#                                                   ####                                                                  #
#                                                   ####                                                                  #
#                                                                                                                         #
#                                                                                                                         #
#                                                                                                                         #
#                                                                                                                         #
#                                                                                                                         #
#                                                                                                                         #
#                                                                    ####                                                 #
#                                                                    ####                                                 #
#                                                                    ####                                                 #
#                                                                    ####                                                 #
#                                                                                                                         #
#                                                                                                                         #
#                                                                                                                         #
#                                                                                                                         #
###########################################################################################################################